posNeg,deathIncrease,hospitalizedIncrease,negativeIncrease,positiveIncrease,totalTestResultsIncrease
8664,0,2,308,8,316
34077,11,32,723,237,960
21834,3,0,614,89,703
3,0,0,0,0,0
45310,11,0,1058,156,1214
216486,63,0,13192,1086,14278
39580,21,63,588,250,838
50143,197,0,3536,766,4302
11525,5,0,-132,139,7
13102,5,0,545,253,798
213509,72,284,9185,1144,10329
64090,51,153,1531,764,2295
978,0,0,32,0,32
19803,0,1,370,13,383
19869,4,0,888,96,984
15398,6,6,273,11,284
116929,80,0,4967,1346,6313
48396,48,0,1951,428,2379
14668,7,15,453,68,521
27697,11,14,852,162,1014
121928,90,0,3073,433,3506
132023,151,0,3717,1755,5472
55763,47,109,1470,560,2030
14846,4,2,2468,36,2504
89697,153,0,2413,1058,3471
40242,8,40,887,114,1001
49012,14,0,825,209,1034
40,0,0,0,0,0
38151,11,49,0,273,273
9583,0,1,344,5,349
67827,9,0,2689,99,2788
11317,0,2,377,24,401
11729,2,0,342,30,372
12166,9,26,437,119,556
144021,351,0,2041,2206,4247
32850,5,0,818,62,880
27655,11,0,871,123,994
526012,752,0,15298,11571,26869
71552,37,81,3040,638,3678
29219,15,22,871,79,950
33351,3,20,958,30,988
137584,63,0,2808,1145,3953
7799,6,0,541,51,592
25897,7,0,2719,278,2997
34733,10,0,758,103,861
9859,0,6,383,180,563
80896,11,30,1809,256,2065
151810,46,0,4475,868,5343
47614,1,8,1008,130,1138
44169,41,1048,1077,329,1406
382,0,0,5,0,5
11081,1,0,489,7,496
122854,25,0,28769,156,28925
43047,12,42,1329,166,1495
17656,1,0,556,62,618
6329,1,0,353,12,365
8348,1,0,510,8,518
33117,11,36,3793,142,3935
21131,0,0,257,70,327
3,0,0,0,0,0
44096,9,0,645,104,749
202208,71,0,10336,990,11326
38742,4,21,1201,7,1208
45841,69,0,924,608,1532
11518,14,0,481,103,584
12304,6,0,348,136,484
203180,54,227,6207,766,6973
61795,37,180,3866,908,4774
946,0,0,41,0,41
19420,0,0,571,5,576
18885,6,0,0,189,189
15114,6,3,206,27,233
110616,74,0,3626,1222,4848
46017,38,0,1187,291,1478
14147,7,18,233,50,283
26683,7,6,732,85,817
118422,129,0,9829,502,10331
126551,113,0,3206,1296,4502
53733,40,147,1446,536,1982
12342,1,0,0,36,36
86226,166,0,2216,1366,3582
39241,9,44,769,45,814
47978,19,0,2252,298,2550
40,0,0,0,2,2
37878,13,47,6749,145,6894
9234,0,3,131,5,136
65039,22,0,1443,208,1651
10916,1,2,125,10,135
11357,1,0,328,57,385
11610,0,0,368,35,403
139774,362,0,6065,4240,10305
31970,5,181,1355,100,1455
26661,6,0,1080,117,1197
499143,778,3489,13609,7177,20786
67874,50,123,2584,178,2762
28269,9,31,5295,115,5410
32363,2,12,1193,49,1242
133631,60,0,2693,1146,3839
7207,0,0,324,20,344
22900,7,0,1964,275,2239
33872,15,179,2213,234,2447
9296,0,1,174,120,294
78831,15,54,2423,213,2636
146467,31,0,12523,718,13241
46476,1,12,640,49,689
42763,5,0,938,424,1362
377,0,0,4,0,4
10585,1,0,215,4,219
93929,8,0,0,127,127
41552,16,56,1228,127,1355
17038,0,0,369,14,383
5964,0,2,0,0,0
7830,0,1,-213,5,-208
29182,6,20,7390,209,7599
20804,3,0,952,130,1082
3,0,0,0,0,0
43347,7,0,1075,163,1238
190882,36,0,0,554,554
37534,30,96,1870,791,2661
44309,48,0,1743,1346,3089
10934,3,0,214,80,294
11820,2,0,571,146,717
196207,18,61,12208,1246,13454
57021,31,84,1705,863,2568
905,0,0,77,2,79
18844,1,0,863,13,876
18696,2,0,981,123,1104
14881,0,1,554,19,573
105768,74,0,3860,1173,5033
44539,7,0,1742,308,2050
13864,6,11,572,39,611
25866,3,208,1176,123,1299
108091,44,0,3625,421,4046
122049,88,105,3927,1392,5319
51751,27,115,1276,711,1987
12306,0,4,5520,65,5585
82644,115,0,2210,997,3207
38427,0,0,977,29,1006
45428,4,0,0,228,228
38,0,0,0,0,0
30984,2,1,9410,161,9571
9098,1,0,178,7,185
63388,5,0,953,296,1249
10781,0,1,408,23,431
10972,0,0,258,23,281
11207,0,6,226,56,282
129469,93,0,0,2734,2734
30515,6,0,1752,71,1823
25464,2,0,718,135,853
478357,671,118,10419,6337,16756
65112,21,85,1498,371,1869
22859,3,11,0,99,99
31121,1,10,1306,57,1363
129792,17,0,3536,1366,4902
6863,1,0,141,6,147
20661,10,331,0,311,311
31425,0,0,0,0,0
9002,0,1,311,138,449
76195,8,12,5216,302,5518
133226,16,0,8271,422,8693
45787,0,6,1493,60,1553
41401,8,0,943,473,1416
373,0,0,23,0,23
10366,1,0,504,21,525
93802,17,0,0,187,187
40197,10,19,853,87,940
16655,1,164,383,15,398
5964,1,1,491,14,505
8038,0,0,291,15,306
21583,2,35,0,334,334
19722,3,0,1090,54,1144
3,0,0,0,0,0
42109,7,0,1433,146,1579
190328,110,0,15930,2322,18252
34873,24,64,1837,383,2220
41220,60,0,864,525,1389
10640,3,0,504,97,601
11103,0,0,0,0,0
182753,27,111,8959,861,9820
54453,5,26,2445,293,2738
826,0,0,0,0,0
17968,0,1,416,21,437
17592,7,0,383,77,460
14308,2,3,533,11,544
100735,43,0,6914,1672,8586
42489,13,0,2781,493,3274
13253,1,5,841,69,910
24567,4,0,132,147,279
104045,34,0,6549,581,7130
116730,70,115,5339,2615,7954
49764,29,151,1995,531,2526
6721,0,6,0,17,17
79437,95,0,2778,645,3423
37421,6,21,1823,194,2017
45200,1,0,1892,136,2028
38,0,0,0,0,0
21413,3,20,0,139,139
8913,0,1,322,10,332
62139,1,0,1538,208,1746
10350,1,3,255,15,270
10691,0,0,615,91,706
10925,1,12,388,44,432
126735,167,0,2843,3699,6542
28692,1,0,1511,83,1594
24611,10,0,888,136,1024
461601,758,1915,12385,8236,20621
63243,6,89,2418,417,2835
22760,2,0,0,102,102
29758,4,21,2378,156,2534
124890,13,0,3559,1178,4737
6716,2,0,236,109,345
20350,7,0,1827,316,2143
31425,2,0,1220,112,1332
8553,0,10,445,104,549
70677,0,11,3655,194,3849
124533,17,0,3077,923,4000
44234,0,5,1591,97,1688
39985,11,0,1789,197,1986
350,0,0,0,0,0
9841,2,0,567,16,583
93615,0,0,0,0,0
39257,7,24,1236,128,1364
16257,3,0,771,34,805
5459,0,3,0,0,0
7732,1,3,289,11,300
21249,11,34,0,223,223
18578,1,0,1403,55,1458
3,0,0,0,0,0
40530,11,0,2515,281,2796
172076,0,0,7213,0,7213
32653,0,0,0,0,0
39831,46,0,2571,972,3543
10039,9,0,566,118,684
11103,10,0,-791,153,-638
172933,48,174,9140,963,10103
51715,12,128,4892,676,5568
826,1,0,31,3,34
17531,2,1,1359,23,1382
17132,3,0,1057,122,1179
13764,1,1,627,43,670
92149,81,0,3329,1293,4622
39215,30,0,3647,528,4175
12343,5,19,827,102,929
24288,0,0,0,0,0
96915,51,0,3874,761,4635
108776,87,164,4518,1886,6404
47238,35,296,2064,726,2790
6704,2,3,0,30,30
76014,111,0,2760,1210,3970
35404,7,23,1419,91,1510
43172,13,0,2207,225,2432
38,0,0,0,0,0
21274,11,46,0,173,173
8581,0,5,272,12,284
60393,6,0,2344,404,2748
10080,1,0,457,15,472
9985,2,0,566,65,631
10493,1,10,469,66,535
120193,251,0,3107,3563,6670
27098,0,0,0,0,0
23587,16,0,722,116,838
440980,783,1861,13149,9946,23095
60408,16,104,1526,351,1877
22658,6,18,420,74,494
27224,4,12,1547,50,1597
120153,78,0,5458,1676,7134
6371,3,0,462,63,525
18207,7,0,3577,334,3911
30093,8,0,1768,142,1910
8004,0,4,267,90,357
66828,3,20,3777,252,4029
120533,28,0,3925,890,4815
42546,1,7,1680,104,1784
37999,9,0,1972,568,2540
350,0,0,26,1,27
9258,1,0,994,32,1026
93615,45,0,0,0,0
37893,9,46,1455,145,1600
15452,0,0,874,23,897
5459,0,0,462,-59,403
7432,0,1,198,11,209
21026,6,35,0,199,199
17120,2,0,2117,52,2169
3,0,0,0,0,0
37734,8,0,462,94,556
164863,49,0,200,1163,1363
32653,57,150,2599,855,3454
36288,68,0,2032,754,2786
9355,6,0,494,137,631
11741,0,0,1732,119,1851
162830,36,219,9114,1167,10281
46147,37,192,4145,917,5062
792,0,0,69,2,71
16149,1,0,391,7,398
15953,2,0,862,118,980
13094,6,14,442,121,563
87527,68,0,5205,1465,6670
35040,55,0,2351,556,2907
11414,8,11,579,60,639
24288,17,459,2140,347,2487
92280,53,0,4391,970,5361
102372,96,209,5381,2033,7414
44448,33,65,2136,783,2919
6674,1,6,0,26,26
72044,205,0,3711,1279,4990
33894,7,24,1506,94,1600
40740,19,0,1986,260,2246
38,0,0,0,0,0
21101,6,41,0,209,209
8297,0,5,426,11,437
57645,9,0,9579,257,9836
9608,1,2,609,9,618
9354,1,0,603,68,671
9958,3,6,376,31,407
113523,232,0,2770,3561,6331
27098,3,0,3065,226,3291
22749,6,0,850,128,978
417885,777,2242,15761,10575,26336
58531,18,143,2222,324,2546
22164,8,13,1775,110,1885
25627,0,0,0,0,0
113019,78,0,5666,1751,7417
5846,6,0,418,42,460
14296,6,0,1599,288,1887
28183,5,255,543,273,816
7647,0,2,411,89,500
62799,4,31,2722,228,2950
115718,27,0,8143,1441,9584
40762,4,15,2263,126,2389
35459,12,87,1966,467,2433
323,0,0,22,4,26
8232,1,0,0,51,51
93615,0,0,0,455,455
36293,17,61,1801,183,1984
14555,0,0,661,31,692
5056,0,3,816,90,906
7223,0,0,146,9,155
20827,8,19,1305,400,1705
14951,3,0,302,119,421
3,0,0,0,0,0
37178,9,0,2322,292,2614
163500,50,0,17884,1352,19236
29199,14,83,879,226,1105
33502,103,0,2463,2003,4466
8724,5,0,358,83,441
9890,7,0,1055,279,1334
152549,45,206,8506,909,9415
41085,17,166,1633,665,2298
721,0,0,31,3,34
15751,0,0,577,25,602
14973,2,0,882,125,1007
12531,3,20,611,22,633
80857,66,0,4447,1344,5791
32133,42,0,856,408,1264
10775,15,40,1055,206,1261
21801,8,0,0,197,197
86919,50,0,4260,1253,5513
94958,70,164,5296,2151,7447
41529,14,138,2411,656,3067
6648,2,4,0,23,23
67054,117,0,0,915,915
32294,11,22,1453,88,1541
38494,19,0,4172,212,4384
38,0,0,0,0,0
20892,9,31,0,257,257
7860,0,5,440,22,462
47809,12,0,4597,225,4822
8990,1,0,420,18,438
8683,2,0,674,48,722
9551,0,0,374,0,374
107192,196,0,3186,3590,6776
23807,3,0,1491,71,1562
21771,9,0,1067,138,1205
391549,799,2144,15775,10621,26396
55985,20,117,2280,364,2644
20279,1,25,6774,160,6934
25627,11,2,981,82,1063
105602,29,0,5075,1989,7064
5386,9,0,437,63,500
12409,8,0,0,277,277
27367,4,0,2493,240,2733
7147,0,1,345,54,399
59849,15,56,2959,272,3231
106134,22,0,8999,877,9876
38373,0,10,2127,130,2257
33026,34,70,1984,397,2381
297,0,0,9,1,10
8181,0,0,409,23,432
93160,0,0,0,263,263
34309,12,53,1309,129,1438
13863,1,0,1257,61,1318
4150,0,1,77,9,86
7068,1,4,142,13,155
19122,10,43,3956,250,4206
14530,2,-18,838,54,892
3,0,0,0,0,0
34564,7,0,1038,151,1189
144264,68,0,11943,1092,13035
28094,29,85,962,257,1219
29036,0,0,0,0,0
8283,5,0,231,229,460
8556,0,0,0,0,0
143134,13,63,4264,708,4972
38787,33,219,3991,1083,5074
687,0,0,33,4,37
15149,0,16,1584,23,1607
13966,1,0,1151,97,1248
11898,2,10,612,40,652
75066,82,0,4805,1529,6334
30869,30,0,1669,436,2105
9514,0,0,0,0,0
21604,6,0,1508,141,1649
81406,70,0,6005,746,6751
87511,77,148,4579,1588,6167
38462,21,104,5677,1158,6835
6625,2,2,0,18,18
66139,114,0,0,766,766
30753,5,29,1408,85,1493
34110,5,0,1851,290,2141
38,0,0,12,3,15
20635,8,33,0,88,88
7398,0,3,400,13,413
42987,7,0,1700,205,1905
8552,0,1,835,14,849
7961,2,0,631,72,703
9177,9,15,370,73,443
100416,272,0,2421,3021,5442
22245,1,0,312,108,420
20566,13,0,1696,231,1927
365153,779,2349,14642,10453,25095
53341,26,141,2137,366,2503
13345,12,14,0,52,52
24564,0,0,1499,58,1557
98538,69,0,5580,1680,7260
4886,1,0,300,47,347
12132,5,0,1605,220,1825
24634,12,0,819,135,954
6748,0,3,407,73,480
56618,7,41,3520,224,3744
96258,23,0,6518,1091,7609
36116,0,10,1361,108,1469
30645,12,52,1688,312,2000
287,0,0,20,2,22
7749,0,5,590,30,620
92897,53,0,0,463,463
32871,7,45,1603,178,1781
12545,0,0,436,50,486
4064,0,0,54,5,59
6913,0,0,8,22,30
14916,6,31,0,151,151
13638,0,11,722,71,793
3,0,0,0,0,0
33375,8,0,722,119,841
131229,31,0,12269,1529,13798
26875,10,70,880,222,1102
29036,71,0,1475,875,2350
7823,-2,0,256,114,370
8556,2,0,1307,255,1562
138162,60,317,13465,1423,14888
33713,100,442,935,1504,2439
650,0,0,24,8,32
13542,1,5,0,16,16
12718,1,14,1017,102,1119
11246,3,6,182,69,251
68732,73,0,4503,1287,5790
28764,34,0,2010,563,2573
9514,2,25,375,55,430
19955,14,0,1135,53,1188
74655,70,0,4072,1417,5489
81344,96,194,3550,1365,4915
31627,12,47,1684,326,2010
6607,2,7,0,20,20
65373,118,0,2430,973,3403
29260,4,19,1049,83,1132
31969,14,0,1819,315,2134
23,1,0,2,0,2
20547,8,-98,0,177,177
6985,0,4,175,20,195
41082,13,0,5,351,356
7703,1,1,478,12,490
7258,2,0,433,38,471
8734,0,11,318,46,364
94974,229,0,2616,3326,5942
21825,0,0,2627,62,2689
18639,12,0,876,134,1010
340058,731,1880,11073,8174,19247
50838,25,140,2128,332,2460
13293,16,36,10399,145,10544
23007,6,66,1157,49,1206
91278,78,0,5845,1579,7424
4539,2,0,534,60,594
10307,3,0,1678,148,1826
23680,7,0,4336,368,4704
6268,2,0,216,32,248
52874,7,56,5188,336,5524
88649,14,0,2306,986,3292
34647,0,10,1190,63,1253
28645,9,66,3669,455,4124
265,0,0,0,0,0
7129,0,0,464,32,496
92434,15,0,0,364,364
31090,15,77,1938,138,2076
12059,0,0,2052,67,2119
4005,0,10,70,6,76
6883,0,3,593,6,599
14765,5,9,1515,172,1687
12845,0,7,1558,45,1603
3,0,0,0,0,0
32534,1,0,4937,187,5124
117431,24,0,0,898,898
25773,14,49,1488,385,1873
26686,17,0,2185,1231,3416
7453,2,0,520,99,619
6994,0,0,0,0,0
123274,18,110,8697,1173,9870
31274,18,49,2775,667,3442
618,0,0,12,1,13
13526,0,2,551,20,571
11599,3,14,680,78,758
10995,0,11,710,24,734
62942,33,0,2953,1006,3959
26191,12,0,3006,533,3539
9084,3,15,763,98,861
18767,5,0,2066,38,2104
69166,35,0,6984,1857,8841
76429,29,96,3155,1337,4492
29617,24,123,844,436,1280
6587,0,6,0,29,29
61970,110,0,2789,1283,4072
28128,1,21,1300,51,1351
29835,5,0,2231,355,2586
21,0,0,0,0,0
20370,8,0,13052,100,13152
6790,0,0,174,13,187
40726,2,0,396,285,681
7213,0,1,408,18,426
6787,0,0,820,46,866
8370,0,6,290,48,338
89032,86,0,3281,3585,6866
19136,1,0,2227,81,2308
17629,0,0,681,117,798
320811,599,2111,9873,8658,18531
48378,23,110,4215,407,4622
2749,5,10,21,75,96
21801,0,0,1113,64,1177
83854,12,73,4613,1470,6083
3945,1,0,359,38,397
8481,2,0,1140,160,1300
18976,0,0,0,0,0
6020,2,1,379,48,427
47350,21,24,1881,169,2050
85357,13,0,13955,464,14419
33394,5,14,2432,70,2502
24521,3,66,609,241,850
265,0,0,16,1,17
6633,1,0,20,31,51
92070,13,0,3064,347,3411
29014,9,44,1405,173,1578
9940,1,0,1081,21,1102
3929,0,0,679,13,692
6284,1,4,230,14,244
13078,2,19,2009,216,2225
11242,2,24,785,87,872
3,0,0,0,0,0
27410,12,0,0,250,250
116533,43,0,1421,1412,2833
23900,15,52,1437,392,1829
23270,24,0,842,399,1241
6834,1,0,300,96,396
6994,0,0,447,80,527
113404,27,110,10297,1040,11337
27832,10,44,1051,487,1538
605,0,0,21,19,40
12955,1,1,645,32,677
10841,8,12,519,82,601
10261,0,4,1327,64,1391
58983,31,0,4503,899,5402
22652,11,0,2394,458,2852
8223,1,11,596,49,645
16663,3,0,1005,86,1091
60325,68,0,1313,514,1827
71937,15,77,2373,764,3137
28337,14,115,2243,484,2727
6558,0,3,0,14,14
57898,77,0,2926,1172,4098
26777,5,22,1284,70,1354
27249,10,0,2268,76,2344
21,0,0,0,0,0
7218,8,39,447,183,630
6603,1,0,405,21,426
40045,7,0,1089,183,1272
6787,0,1,559,21,580
5921,2,0,500,42,542
8032,2,6,446,81,527
82166,71,0,3429,3381,6810
16828,1,0,1148,48,1196
16831,0,0,574,94,668
302280,594,1709,10332,8327,18659
43756,17,98,1581,304,1885
2653,4,14,39,93,132
20624,1,19,3021,69,3090
77771,14,68,6248,1493,7741
3548,2,0,468,23,491
7181,8,0,675,116,791
18976,4,0,530,132,662
5593,0,3,341,28,369
45300,1,17,3597,312,3909
70938,22,0,6485,702,7187
30892,0,7,2672,177,2849
23671,-1,41,1889,230,2119
248,1,0,22,2,24
6582,2,0,687,51,738
88659,20,0,4694,398,5092
27436,12,36,1310,155,1465
8838,1,0,1110,42,1152
3237,0,0,95,10,105
6040,2,1,10,14,24
10853,8,212,1086,148,1234
10370,2,1,632,39,671
3,0,0,0,0,0
27160,11,0,2237,250,2487
113700,39,0,77075,1325,78400
22071,14,113,1215,445,1660
22029,34,0,1652,362,2014
6438,6,0,709,145,854
6467,0,0,879,143,1022
102067,28,175,8819,1526,10345
26294,17,81,700,329,1029
565,0,0,13,9,22
12278,1,3,1753,34,1787
10240,3,15,700,87,787
8870,1,6,803,122,925
53581,33,0,4080,1453,5533
19800,14,0,1449,516,1965
7578,4,21,426,78,504
15572,6,0,2707,61,2768
58498,39,0,2654,2199,4853
68800,24,102,4504,1334,5838
25610,11,157,1553,367,1920
6544,1,8,0,24,24
53800,61,0,3735,1143,4878
25423,2,24,1120,76,1196
24905,5,0,3257,178,3435
21,0,0,0,0,0
6588,6,16,380,97,477
6177,0,0,579,22,601
38773,5,0,6866,309,7175
6207,0,1,396,13,409
5379,0,0,571,42,613
7505,2,7,390,61,451
75356,200,0,3624,4229,7853
15632,3,0,762,92,854
16163,3,0,1403,228,1631
283621,630,2687,12260,10841,23101
41871,11,111,3069,427,3496
2521,4,27,47,171,218
17534,4,35,0,100,100
70030,34,152,6318,1597,7915
3057,3,0,556,74,630
6390,3,0,727,97,824
18314,9,0,10956,363,11319
5224,0,2,419,25,444
41391,6,18,3298,254,3552
63751,15,0,7207,780,7987
28043,1,11,3613,182,3795
21552,6,78,2152,395,2547
224,0,0,30,2,32
5844,3,0,544,72,616
83567,20,0,2800,386,3186
25971,19,101,1482,200,1682
7686,0,0,1274,45,1319
3132,0,2,241,25,266
6016,0,6,980,14,994
9619,3,0,684,199,883
9699,0,5,1115,61,1176
3,0,0,0,0,0
24673,9,0,1793,171,1964
35300,34,0,790,1510,2300
20411,17,90,1380,386,1766
20015,19,0,625,1090,1715
5584,3,0,410,104,514
5445,2,0,429,57,486
91722,35,164,12851,1575,14426
25265,21,102,1825,483,2308
543,1,0,17,2,19
10491,1,0,0,27,27
9453,0,18,700,85,785
7945,0,7,441,222,663
48048,53,0,3183,1209,4392
17835,24,0,1152,398,1550
7074,4,13,395,68,463
12804,11,0,4814,90,4904
53645,60,0,1412,1147,2559
62962,38,153,4918,1436,6354
23690,6,82,2042,427,2469
6520,2,7,0,56,56
48922,62,0,3302,1135,4437
24227,4,18,1786,47,1833
21470,0,0,1508,279,1787
21,0,0,0,0,0
6111,3,60,0,181,181
5576,0,4,240,16,256
31598,3,0,2683,236,2919
5798,0,1,804,14,818
4766,1,0,509,33,542
7054,1,15,497,64,561
67503,109,0,4088,4305,8393
14778,1,0,727,40,767
14532,5,0,430,56,486
260520,562,2879,11073,10482,21555
38375,10,93,3047,410,3457
2303,4,32,50,109,159
17434,1,16,1276,73,1349
62115,12,122,5997,1404,7401
2427,3,0,445,62,507
5566,2,0,445,52,497
6995,0,-655,0,0,0
4780,0,0,376,22,398
37839,5,30,3006,222,3228
55764,20,0,4424,661,5085
24248,0,6,2847,172,3019
19005,5,7,1110,306,1416
192,0,0,5,5,10
5228,0,0,128,51,179
80381,29,0,4019,586,4605
24289,6,26,2060,182,2242
6367,0,0,854,20,874
2866,0,2,265,12,277
5022,0,0,409,10,419
8736,6,0,806,156,962
8523,2,10,526,59,585
3,0,0,0,0,0
22709,3,0,1466,185,1651
33000,32,0,2037,1036,3073
18645,11,111,1420,376,1796
18300,27,0,1433,267,1700
5070,1,0,1155,67,1222
4959,1,0,551,25,576
77296,41,174,9757,1055,10812
22957,24,104,1921,710,2631
524,0,0,36,5,41
10464,0,2,1485,50,1535
8668,2,21,750,65,815
7282,0,3,537,144,681
43656,16,0,2557,715,3272
16285,13,0,1436,474,1910
6611,3,24,648,70,718
7900,3,0,255,89,344
51086,37,0,2584,2726,5310
56608,32,131,3642,1228,4870
21221,5,60,1657,346,2003
6464,0,5,0,32,32
44485,80,0,3131,1229,4360
22394,1,16,1150,53,1203
19683,1,0,2003,253,2256
21,1,0,13,2,15
5930,4,28,1041,104,1145
5320,0,3,383,19,402
28679,6,0,2163,273,2436
4980,0,5,470,17,487
4224,1,0,503,36,539
6493,0,2,93,0,93
59110,182,0,3133,3335,6468
14011,1,0,723,48,771
14046,12,0,1069,179,1248
238965,432,2449,9416,8669,18085
34918,16,123,5024,355,5379
2144,4,38,17,160,177
16085,3,34,2123,90,2213
54714,16,110,5271,1211,6482
1920,1,0,195,30,225
5069,2,0,581,91,672
6995,5,547,408,261,669
4382,0,5,314,36,350
34611,8,63,1997,162,2159
50679,12,0,2150,672,2822
21229,0,9,0,62,62
17589,7,0,2023,222,2245
182,0,0,23,3,26
5049,1,0,537,17,554
75776,26,0,8248,369,8617
22047,7,63,1498,180,1678
5493,1,0,892,26,918
2589,0,1,221,20,241
4603,0,2,876,14,890
7774,13,0,399,96,495
7938,2,90,1395,61,1456
3,0,0,0,0,0
21058,5,0,1563,124,1687
29927,18,0,0,673,673
16849,18,95,1146,339,1485
16600,16,0,14,429,443
3848,2,0,0,91,91
4383,1,0,319,49,368
66484,10,126,5244,617,5861
20326,28,119,3436,709,4145
483,1,0,35,8,43
8929,1,1,250,4,254
7853,2,5,416,52,468
6601,2,1,779,110,889
40384,42,0,4173,986,5159
14375,16,0,596,406,1002
5893,1,35,415,54,469
7556,6,0,635,111,746
45776,34,0,5622,1187,6809
51738,33,120,3685,1118,4803
19218,13,93,2365,325,2690
6432,2,6,0,41,41
40125,78,0,3258,1013,4271
21191,5,10,1351,60,1411
17427,4,0,1232,254,1486
6,0,0,0,4,4
4785,2,121,175,136,311
4918,1,3,476,24,500
26243,2,0,3051,86,3137
4493,0,2,220,16,236
3685,1,0,544,38,582
6400,1,11,572,101,673
52642,88,0,3310,3559,6869
13240,1,0,679,34,713
12798,9,0,838,166,1004
220880,391,2464,7777,7917,15694
29539,10,94,0,348,348
1967,7,42,19,154,173
13872,0,0,0,46,46
48232,11,106,4782,962,5744
1695,3,0,214,47,261
4397,2,0,355,77,432
6326,4,90,417,210,627
4032,1,0,294,21,315
32452,1,25,4648,444,5092
47857,17,0,4134,731,4865
21167,2,18,2529,125,2654
15344,7,140,1709,234,1943
156,0,0,0,0,0
4495,3,9,217,28,245
67159,18,0,0,563,563
20369,8,61,1444,199,1643
4575,0,0,403,29,432
2348,0,1,219,21,240
3713,0,0,54,5,59
7279,7,0,604,122,726
6482,1,0,697,50,747
3,0,0,3,0,3
19371,4,0,2480,132,2612
29254,20,0,1223,1035,2258
15364,0,0,0,0,0
16157,33,0,1000,557,1557
3757,0,0,580,94,674
4015,4,0,1480,55,1535
60623,14,171,6060,865,6925
16181,24,126,2337,1120,3457
440,1,0,19,11,30
8675,0,0,646,29,675
7385,1,20,726,73,799
5712,1,6,901,105,1006
35225,26,0,3842,937,4779
13373,14,0,1342,373,1715
5424,1,13,442,60,502
6810,2,0,751,41,792
38967,54,0,3722,1212,4934
46935,33,109,3274,868,4142
16528,3,76,1552,247,1799
6391,2,8,2694,28,2722
35854,75,0,2796,974,3770
19780,2,20,905,53,958
15941,1,0,1410,296,1706
2,0,0,0,0,0
4474,4,16,548,90,638
4418,0,4,91,13,104
23106,2,0,2051,191,2242
4257,1,2,403,17,420
3103,1,0,347,27,374
5727,0,0,27,0,27
45773,69,0,1853,2060,3913
12527,2,0,1304,44,1348
11794,2,0,474,105,579
205186,332,2183,9420,9298,18718
29191,16,110,1650,266,1916
1794,6,24,22,84,106
13826,2,14,859,84,943
42488,14,128,3868,756,4624
1434,2,0,264,65,329
3965,4,0,289,87,376
5699,4,130,456,158,614
3717,0,12,131,7,138
27360,10,27,3651,405,4056
42992,7,0,6723,389,7112
18513,1,73,2429,81,2510
13401,2,29,1133,230,1363
156,0,0,0,0,0
4250,1,18,283,37,320
66596,13,0,0,464,464
18726,2,337,1519,130,1649
4143,0,0,997,36,1033
2108,0,0,159,15,174
3654,1,1,308,12,320
6553,2,0,1510,53,1563
5735,1,0,2235,47,2282
0,0,0,0,0,0
16759,3,0,2649,238,2887
26996,10,0,0,739,739
15364,7,140,1522,566,2088
14600,2,0,2122,578,2700
3083,4,0,213,59,272
2480,0,0,2180,32,2212
53698,7,58,9155,1227,10382
12724,7,41,2,158,160
410,0,0,18,2,20
8000,0,0,976,24,1000
6586,2,6,1149,88,1237
4706,1,3,375,49,424
30446,8,0,2223,461,2684
11658,3,0,1556,272,1828
4922,2,11,360,49,409
6018,0,0,432,45,477
34033,34,0,5677,485,6162
42793,8,54,2930,797,3727
14729,5,76,962,174,1136
3669,0,49,0,22,22
32084,52,0,5507,891,6398
18822,1,17,1092,73,1165
14235,3,0,1657,193,1850
2,0,0,0,0,0
3836,2,-40,429,89,518
4314,3,2,0,17,17
20864,2,0,1652,267,1919
3837,1,2,373,11,384
2729,0,0,616,37,653
5700,1,12,862,100,962
41860,37,0,3008,3250,6258
11179,0,0,173,0,173
11215,1,0,1795,270,2065
186468,253,1646,7124,6984,14108
27275,10,72,6330,280,6610
1688,1,13,2,52,54
12883,3,11,1399,58,1457
37864,11,33,3716,693,4409
1105,1,0,90,47,137
3589,1,0,347,108,455
5085,2,0,1145,151,1296
3579,0,0,351,11,362
23304,6,15,2433,297,2730
35880,0,0,9795,325,10120
16003,2,0,1923,87,2010
12038,3,24,1299,130,1429
156,0,0,3,7,10
3930,0,0,208,21,229
66132,11,0,5670,464,6134
17077,1,0,-694,109,-585
3110,1,0,279,13,292
1934,0,2,286,8,294
3334,0,1,396,17,413
4990,1,0,0,110,110
3453,1,0,89,22,111
0,0,0,0,0,0
13872,2,0,5498,46,5544
26257,22,0,0,1065,1065
13276,13,35,1273,327,1600
11900,7,0,2798,702,3500
2811,1,0,258,38,296
268,3,0,0,18,18
43316,2,68,3704,483,4187
12564,11,49,1228,285,1513
390,0,0,35,1,36
7000,0,4,2492,31,2523
5349,1,7,638,38,676
4282,1,11,679,31,710
27762,18,0,1166,1105,2271
9830,1,0,1141,282,1423
4513,1,28,523,58,581
5541,1,0,326,92,418
27871,14,0,2485,225,2710
39066,4,49,3319,698,4017
13593,5,51,838,247,1085
3647,2,0,0,42,42
25686,40,0,1493,723,2216
17657,4,18,1466,62,1528
12385,0,0,1465,0,1465
2,0,0,0,0,0
3318,1,16,0,95,95
4297,0,1,887,25,912
18945,0,0,1313,105,1418
3453,0,1,546,15,561
2076,0,0,64,12,76
4738,0,3,868,27,895
35602,21,0,2830,2262,5092
11006,1,0,1573,46,1619
9150,4,0,511,117,628
172360,237,2021,9231,7195,16426
20665,4,59,0,247,247
1634,1,14,25,52,77
11426,0,12,1185,69,1254
33455,4,37,4807,643,5450
968,2,0,102,27,129
3134,3,0,299,55,354
3789,3,0,607,235,842
3217,0,0,535,22,557
20574,1,15,2072,164,2236
25760,7,0,0,500,500
13993,0,0,2564,117,2681
10609,5,13,1292,151,1443
146,0,0,17,1,18
3701,0,0,1303,24,1327
59998,17,0,5881,395,6276
17662,0,0,1318,123,1441
2818,0,0,374,17,391
1640,0,1,79,4,83
2921,1,2,517,16,533
4880,0,0,0,109,109
3342,2,0,1393,23,1416
0,0,0,0,0,0
8328,2,0,0,137,137
25192,23,0,3169,764,3933
11676,7,55,1250,304,1554
8400,0,0,0,0,0
2515,1,0,314,37,351
250,1,0,0,51,51
39129,20,70,7180,998,8178
11051,5,51,821,365,1186
354,0,0,0,4,4
4477,0,1,0,14,14
4673,0,11,635,63,698
3572,1,25,674,41,715
25491,13,0,3484,465,3949
8407,7,0,1220,251,1471
3932,1,0,442,59,501
5123,2,0,1053,54,1107
25161,18,0,3233,569,3802
35049,9,131,4661,1017,5678
12508,0,53,11422,218,11640
3605,0,0,0,43,43
23470,0,0,1544,628,2172
16129,1,6,2083,43,2126
10920,2,0,9713,169,9882
2,0,0,0,2,2
3223,5,34,0,84,84
3385,1,0,666,21,687
17527,1,0,2219,172,2391
2892,1,3,382,18,400
2000,2,0,143,11,154
3843,1,5,261,29,290
30510,32,0,2839,2299,5138
9387,0,0,819,55,874
8522,0,0,1740,86,1826
155934,209,1528,2498,7683,10181
20418,6,68,0,269,269
1557,7,21,96,55,151
10172,1,15,1183,65,1248
28005,12,75,4238,533,4771
839,0,0,220,21,241
2780,0,0,235,36,271
2947,4,20,101,83,184
2660,0,0,205,10,215
18338,0,15,2077,170,2247
25260,4,0,1273,321,1594
11312,0,0,1946,122,2068
9166,3,16,1694,135,1829
128,0,0,51,3,54
2374,2,0,86,27,113
53722,20,0,5842,469,6311
16221,0,0,2092,147,2239
2427,0,0,552,20,572
1557,0,3,264,12,276
2388,0,0,518,10,528
4771,2,0,591,81,672
1926,0,0,41,46,87
0,0,0,0,0,0
8191,5,0,7108,159,7267
21259,13,0,0,873,873
10122,5,36,1714,344,2058
8400,6,0,1484,279,1763
2164,0,0,271,36,307
199,1,0,0,33,33
30951,6,50,4445,410,4855
9865,16,93,463,476,939
350,0,0,36,6,42
4463,0,2,0,11,11
3975,2,4,1162,56,1218
2857,3,0,603,66,669
21542,8,0,4423,488,4911
6936,7,0,1949,336,2285
3431,1,27,360,34,394
4016,2,0,666,50,716
21359,36,0,2889,441,3330
29371,10,0,4927,823,5750
868,1,41,0,194,194
3562,1,0,0,13,13
21298,32,0,2334,892,3226
14003,2,10,1001,52,1053
1038,0,0,0,167,167
0,0,0,0,0,0
3139,2,35,269,94,363
2698,0,6,462,37,499
15136,1,0,2099,127,2226
2492,0,3,388,13,401
1846,0,0,177,12,189
3553,0,6,394,21,415
25372,27,0,2886,1949,4835
8513,0,0,696,24,720
6696,0,0,1464,115,1579
145753,134,1682,16272,7377,23649
20149,4,53,2563,270,2833
1406,1,19,126,74,200
8924,1,12,1557,87,1644
23234,6,241,4575,531,5106
598,1,0,142,15,157
2509,0,0,1044,38,1082
2763,0,0,0,0,0
2445,0,0,414,12,426
16091,3,27,936,246,1182
23666,5,0,1907,335,2242
9244,1,0,1456,78,1534
7337,1,18,1004,144,1148
74,0,0,0,2,2
2261,1,18,227,26,253
47411,14,0,11461,493,11954
13982,5,0,1557,135,1692
1855,0,0,748,25,773
1281,0,11,159,17,176
1860,0,2,152,17,169
4099,1,0,1064,223,1287
1839,1,0,67,55,122
0,0,0,0,0,0
924,2,0,24,127,151
20386,12,0,1459,651,2110
8064,8,64,189,174,363
6637,2,0,602,137,739
1857,1,0,203,48,251
166,1,0,0,15,15
26096,6,90,8367,673,9040
8926,8,79,2469,278,2747
308,0,0,30,8,38
4452,0,-1,0,5,5
2757,0,10,0,34,34
2188,0,0,178,50,228
16631,7,0,1749,673,2422
4651,3,0,1127,168,1295
3037,0,0,509,42,551
3300,0,0,237,41,278
18029,18,0,6068,510,6578
23621,10,116,3248,579,3827
674,0,132,0,157,157
3549,0,0,217,6,223
18072,17,0,2768,707,3475
12950,1,6,1416,59,1475
871,0,0,0,146,146
0,0,0,0,0,0
2776,4,33,725,108,833
2199,0,1,180,18,198
12910,1,0,2289,132,2421
2091,0,2,305,13,318
1657,0,0,280,12,292
3138,0,6,645,29,674
20537,19,0,3209,2474,5683
7793,0,0,939,12,951
5117,4,0,446,99,545
122104,100,3039,12178,6447,18625
17316,5,41,2389,163,2552
1206,2,27,153,84,237
7280,3,29,2603,118,2721
18128,5,0,5248,560,5808
441,0,0,60,13,73
1427,0,0,0,33,33
2763,2,7,4,32,36
2019,0,0,1154,5,1159
14909,0,23,2940,173,3113
21424,6,0,7508,422,7930
7710,0,0,817,56,873
6189,4,6,750,69,819
72,0,0,0,0,0
2008,1,0,261,35,296
35457,22,0,0,470,470
12290,1,0,1494,122,1616
1082,0,0,272,12,284
1105,0,0,98,9,107
1691,1,1,663,6,669
2812,0,0,423,68,491
1717,2,0,490,62,552
0,0,0,0,0,0
773,1,0,10,93,103
18276,13,0,2469,253,2722
7701,4,12,1285,192,1477
5898,7,0,341,257,598
1606,0,0,228,46,274
151,0,0,0,24,24
17056,4,57,2247,270,2517
6179,8,394,474,221,695
270,0,0,32,5,37
4447,0,2,768,13,781
2723,1,9,263,21,284
1960,0,0,0,23,23
14209,3,0,2410,330,2740
3356,2,0,313,112,425
2486,1,0,274,28,302
3022,0,0,1103,33,1136
11451,19,0,2441,407,2848
19794,4,9,5366,679,6045
517,1,0,0,74,74
3326,0,0,163,24,187
14597,19,0,1741,619,2360
11475,0,14,5638,25,5663
725,5,0,0,173,173
0,0,0,0,0,0
1943,1,31,14,57,71
2001,0,0,305,7,312
10489,1,0,1844,106,1950
1773,0,3,280,5,285
1365,0,0,329,9,338
2464,0,2,909,7,916
14854,18,0,2127,727,2854
6842,1,0,852,17,869
4572,2,0,297,43,340
103479,75,571,7063,5146,12209
14764,2,37,13920,140,14060
969,2,34,70,58,128
4559,0,0,0,0,0
12320,4,0,2550,276,2826
368,0,0,49,12,61
1394,0,0,62,8,70
2727,2,102,291,126,417
860,0,0,29,11,40
11796,1,53,495,117,612
13494,3,0,1763,564,2327
6837,0,0,967,47,1014
5370,2,14,799,101,900
72,0,0,55,0,55
1712,1,0,149,28,177
34987,13,0,0,452,452
10674,2,0,1852,128,1980
798,0,0,149,19,168
998,0,0,244,15,259
1022,0,0,40,14,54
2321,0,0,441,48,489
1165,0,0,41,44,85
0,0,0,0,0,0
670,3,0,4,92,96
15554,13,0,885,369,1254
6224,1,14,659,129,788
5300,2,0,597,203,800
1332,0,0,82,21,103
127,0,0,0,23,23
14539,4,42,2064,241,2305
5484,7,0,161,254,415
233,0,0,40,3,43
3666,0,4,634,21,655
2439,0,27,272,19,291
1937,0,0,578,3,581
11469,4,0,1351,262,1613
2931,5,0,865,106,971
2184,0,0,1669,16,1685
1886,1,0,0,20,20
8603,12,0,2439,216,2655
13749,2,15,4445,382,4827
443,0,0,0,61,61
3139,0,0,223,18,241
12237,9,0,1099,652,1751
5812,0,4,1039,27,1066
552,0,0,0,0,0
0,0,0,0,0,0
1872,0,53,409,71,480
1689,0,0,497,12,509
8539,0,0,0,101,101
1488,0,1,101,4,105
1027,0,0,619,2,621
1548,1,11,73,23,96
12000,17,0,7966,831,8797
5973,0,0,569,18,587
4232,0,0,464,33,497
91270,96,599,8191,4790,12981
704,2,41,0,122,122
841,1,10,41,25,66
4559,3,5,701,18,719
9494,1,0,2048,207,2255
307,0,0,79,8,87
1324,0,0,57,18,75
2310,0,0,546,0,546
820,0,0,28,2,30
11184,0,0,7245,52,7297
11167,1,0,1054,58,1112
5823,0,0,734,42,776
4470,1,7,737,36,773
17,0,0,0,0,0
1535,2,0,334,20,354
34535,9,0,2833,373,3206
8694,0,0,1187,41,1228
630,0,0,166,4,170
739,0,0,118,3,121
968,0,0,0,0,0
1832,0,0,201,29,230
1080,0,0,195,9,204
0,0,0,0,0,0
574,0,0,27,113,140
14300,0,0,1263,197,1460
5436,1,9,770,116,886
4500,5,0,1208,192,1400
1229,1,0,156,18,174
104,0,0,0,12,12
12234,1,32,3073,341,3414
5069,2,0,877,172,1049
190,0,0,35,2,37
3011,0,0,2692,8,2700
2148,0,0,828,15,843
1356,0,0,134,5,139
9856,3,0,1312,224,1536
1960,1,0,408,58,466
499,0,0,0,18,18
1866,0,0,290,5,295
5948,14,0,2115,335,2450
8922,4,8,2686,131,2817
382,0,0,0,44,44
2898,0,0,527,18,545
10486,7,0,985,691,1676
4746,0,5,0,66,66
552,0,0,0,93,93
0,0,0,0,0,0
1392,0,0,29,42,71
1180,0,0,0,3,3
8438,0,0,1958,42,2000
1383,0,1,93,2,95
406,0,0,0,2,2
1452,0,0,186,13,199
3203,7,0,32,930,962
5386,0,0,599,8,607
3735,2,0,1042,55,1097
78289,0,661,11181,5707,16888
582,3,21,0,91,91
775,0,4,25,14,39
3840,1,13,785,30,815
7239,4,0,1631,165,1796
220,2,0,6,8,14
1249,0,0,211,23,234
1764,2,0,0,103,103
790,0,0,22,7,29
3887,2,0,0,110,110
10055,3,0,1281,18,1299
5047,0,0,1282,76,1358
3697,3,6,325,35,360
17,0,0,0,11,11
1181,3,0,0,23,23
31329,11,0,3551,208,3759
7466,1,0,820,31,851
460,0,0,59,4,63
618,0,0,154,2,156
968,0,0,188,8,196
1602,0,0,1436,14,1450
876,0,0,144,47,191
0,0,0,0,0,0
434,1,0,42,48,90
12840,3,0,55,257,312
4550,1,5,758,112,870
3100,1,0,771,29,800
1055,0,0,451,21,472
92,0,0,0,11,11
8820,1,27,1411,172,1583
4020,9,0,863,93,956
153,1,0,18,12,30
311,0,0,139,11,150
1305,0,0,166,22,188
1217,0,0,295,11,306
8320,3,0,1783,296,2079
1494,2,0,586,75,661
481,0,0,0,9,9
1571,1,0,758,45,803
3498,4,0,481,252,733
6105,4,10,707,121,828
338,1,0,0,54,54
2353,0,0,0,16,16
8810,3,0,16,555,571
4680,0,12,559,31,590
459,0,0,0,17,17
0,0,0,0,0,0
1321,0,33,419,67,486
1177,0,0,0,11,11
6438,0,0,1091,71,1162
1288,0,0,119,0,119
404,0,0,0,10,10
1253,0,0,215,10,225
2241,4,0,33,587,620
4779,0,0,951,0,951
2638,0,0,64,66,130
61401,70,371,11152,4812,15964
491,0,25,0,104,104
736,1,1,109,14,123
3025,1,43,861,47,908
5443,0,0,1198,108,1306
206,0,0,40,2,42
1015,0,0,70,17,87
1661,2,0,211,43,254
761,0,0,49,7,56
3777,0,0,0,134,134
8756,0,0,2204,30,2234
3689,1,0,1084,45,1129
3337,1,7,480,67,547
6,0,0,0,0,0
1158,0,0,327,23,350
27570,14,0,3609,236,3845
6615,0,0,1602,104,1706
397,0,0,55,1,56
462,0,0,0,1,1
772,0,0,72,2,74
152,0,0,0,43,43
685,0,0,216,22,238
0,0,0,0,0,0
344,1,0,29,39,68
12528,4,0,825,216,1041
3680,1,44,642,86,728
2300,1,0,1502,0,1502
583,0,0,5,6,11
81,0,0,0,7,7
7237,2,158,4709,138,4847
3064,1,0,591,87,678
123,0,0,22,1,23
161,0,0,0,11,11
1117,0,0,407,23,430
911,0,0,290,8,298
6241,1,0,1792,168,1960
833,2,1,232,47,279
472,1,0,0,11,11
768,1,0,122,7,129
2765,4,0,1612,106,1718
5277,0,61,1074,112,1186
284,1,0,0,41,41
2337,0,0,0,16,16
8239,2,0,950,516,1466
4090,1,0,211,23,234
442,2,0,0,26,26
0,0,0,0,0,0
835,0,0,0,60,60
1166,0,0,215,4,219
5276,0,0,1996,47,2043
1169,0,3,341,8,349
394,0,0,116,6,122
1028,0,0,228,11,239
1621,5,0,30,437,467
3828,0,0,0,14,14
2508,1,0,392,15,407
45437,9,1603,9756,3254,13010
387,2,58,0,78,78
613,0,10,22,4,26
2117,0,0,0,0,0
4137,1,0,1192,103,1295
164,0,0,29,7,36
928,0,0,62,12,74
1407,0,0,422,71,493
705,0,0,28,0,28
3643,0,0,2709,143,2852
6522,0,0,1135,110,1245
2560,0,0,389,24,413
2790,0,25,427,38,465
6,0,0,0,3,3
808,0,0,0,0,0
23725,6,0,2383,233,2616
4909,1,0,1173,75,1248
341,0,1,111,4,115
461,0,0,107,4,111
698,0,0,254,6,260
109,0,0,0,13,13
447,0,0,41,50,91
0,0,0,0,0,0
276,0,0,36,21,57
11487,2,0,1637,139,1776
2952,1,0,563,61,624
798,2,0,0,98,98
572,1,0,348,32,380
74,0,0,0,8,8
2390,2,0,337,130,467
2386,3,0,422,133,555
100,0,0,17,2,19
150,0,0,31,10,41
687,0,0,559,7,566
613,0,0,131,12,143
4281,1,0,971,163,1134
554,0,0,151,23,174
461,0,0,0,10,10
639,0,0,138,12,150
1047,4,0,110,132,242
4091,1,0,874,85,959
243,0,0,0,42,42
2321,0,0,260,4,264
6773,0,0,961,635,1596
3856,0,0,792,26,818
416,0,0,61,23,84
0,0,0,0,0,0
775,1,0,143,30,173
947,0,0,170,4,174
3233,0,0,688,40,728
820,0,0,307,5,312
272,0,0,0,5,5
789,0,0,124,5,129
1154,2,0,54,148,202
3814,0,0,1009,8,1017
2101,0,0,366,14,380
32427,23,0,7193,2950,10143
309,1,0,0,50,50
587,0,0,72,5,77
2117,0,0,674,26,700
2842,0,0,966,83,1049
128,0,0,58,9,67
854,0,0,146,10,156
914,0,0,250,21,271
677,0,0,112,3,115
791,0,0,214,74,288
5277,2,0,2871,51,2922
2147,0,0,587,34,621
2325,0,0,382,20,402
3,0,0,0,0,0
808,2,0,134,7,141
21109,11,0,3418,238,3656
3661,3,0,1263,51,1314
226,0,0,76,5,81
350,0,0,60,1,61
438,0,0,26,0,26
96,0,0,0,22,22
356,0,0,74,13,87
0,0,0,0,0,0
219,0,0,27,16,43
9711,5,0,806,313,1119
2328,0,0,495,33,528
700,1,0,479,28,507
192,0,0,15,8,23
66,0,0,0,5,5
1923,1,0,308,76,384
1831,9,0,233,90,323
81,0,0,12,4,16
109,0,0,0,2,2
121,0,0,0,9,9
470,0,0,0,2,2
3147,3,0,962,134,1096
380,0,0,170,17,187
451,0,0,0,18,18
489,0,0,100,9,109
805,2,0,123,107,230
3132,0,0,789,72,861
201,1,0,0,22,22
2057,0,0,334,10,344
5177,3,0,570,479,1049
3038,0,0,264,12,276
332,1,0,55,11,66
0,0,0,0,0,0
602,0,0,73,16,89
773,0,0,262,2,264
2505,0,0,621,34,655
508,0,0,225,9,234
267,0,0,34,3,37
660,0,0,108,13,121
952,4,0,20,315,335
2797,0,0,436,7,443
1721,0,0,1458,40,1498
22284,0,0,5917,1770,7687
259,0,0,0,31,31
510,1,0,88,15,103
1417,0,0,211,13,224
1793,0,0,421,52,473
61,0,0,25,0,25
698,0,0,114,11,125
643,0,0,0,0,0
562,0,0,0,0,0
503,0,0,0,56,56
2355,1,0,388,60,448
1526,0,0,1317,15,1332
1923,1,0,628,17,645
3,0,0,0,1,1
667,0,0,53,3,56
17453,10,0,2801,147,2948
2347,0,0,615,49,664
145,0,0,21,1,22
289,0,0,93,3,96
412,0,0,72,3,75
74,0,0,0,10,10
269,0,0,39,11,50
0,0,0,0,0,0
176,0,0,6,8,14
8592,2,0,0,128,128
1800,1,0,561,23,584
193,0,0,0,27,27
169,0,0,34,9,43
61,0,0,0,9,9
1539,1,0,285,128,413
1508,0,0,1311,51,1362
65,0,0,16,3,19
107,0,0,93,4,97
112,0,0,0,6,6
468,0,0,113,2,115
2051,0,0,423,129,552
193,0,0,25,9,34
433,0,0,35,1,36
380,0,0,59,4,63
575,2,0,49,69,118
2271,0,0,474,38,512
179,0,0,0,28,28
1713,0,0,367,11,378
4128,0,0,589,520,1109
2762,0,0,409,17,426
266,0,0,46,5,51
0,0,0,0,0,0
513,0,0,111,13,124
509,0,0,196,2,198
1850,0,0,1313,23,1336
274,0,0,48,3,51
230,0,0,0,3,3
539,0,0,158,9,167
617,2,0,27,160,187
2354,0,0,1077,5,1082
223,0,0,0,0,0
14597,5,0,6709,682,7391
228,0,0,0,21,21
407,0,0,131,12,143
1193,3,0,429,28,457
1320,1,0,308,37,345
36,0,0,18,0,18
573,0,0,137,10,147
643,0,0,272,27,299
562,1,0,0,0,0
447,0,0,19,25,44
1907,1,0,620,19,639
194,0,0,0,12,12
1278,0,0,240,10,250
2,0,0,0,0,0
611,0,0,97,9,106
14505,4,0,1535,170,1705
1683,0,0,539,34,573
123,0,0,42,1,43
193,0,0,83,5,88
337,0,0,191,2,193
64,0,0,0,8,8
219,0,0,65,0,65
0,0,0,0,0,0
162,0,0,17,2,19
8464,5,0,0,148,148
1216,0,0,429,29,458
166,0,0,0,15,15
126,0,0,8,5,13
52,0,0,0,8,8
1126,2,0,256,45,301
146,0,0,0,25,25
46,0,0,18,2,20
10,0,0,0,3,3
106,0,0,0,1,1
353,0,0,81,2,83
1499,1,0,408,66,474
159,1,0,14,6,20
397,0,0,216,4,220
317,0,0,61,1,62
457,2,0,98,57,155
1759,0,0,1189,54,1243
151,0,0,0,20,20
1335,0,0,539,15,554
3019,0,0,354,460,814
2336,0,0,437,6,443
215,0,0,43,2,45
0,0,0,0,0,0
389,0,0,91,9,100
311,0,0,105,1,106
514,0,0,178,7,185
223,0,0,97,2,99
227,0,0,36,3,39
372,0,0,84,4,88
430,1,0,43,89,132
1272,0,0,683,6,689
223,0,0,0,10,10
7206,0,0,963,750,1713
207,0,0,0,17,17
264,0,0,73,7,80
736,0,0,110,8,118
975,0,0,209,20,229
18,0,0,4,0,4
426,0,0,95,2,97
344,0,0,76,5,81
562,0,0,57,1,58
403,0,0,60,21,81
1268,1,0,1204,7,1211
182,0,0,0,12,12
1028,0,0,523,16,539
2,0,0,0,1,1
505,0,0,74,2,76
12800,9,0,2131,166,2297
1110,0,0,534,25,559
80,0,0,0,0,0
105,0,0,95,7,102
144,0,0,0,0,0
56,0,0,0,16,16
154,0,0,29,6,35
0,0,0,0,0,0
143,0,0,4,6,10
8316,1,0,7065,42,7107
758,0,0,0,0,0
151,0,0,0,6,6
113,0,0,17,1,18
44,0,0,0,2,2
825,0,0,6,25,31
121,0,0,0,22,22
26,0,0,0,0,0
7,0,0,0,5,5
105,0,0,0,4,4
270,0,0,91,0,91
1025,0,0,483,29,512
139,1,0,13,5,18
177,0,0,31,3,34
255,1,0,95,5,100
302,0,0,32,23,55
516,0,0,0,26,26
131,0,0,0,6,6
781,0,0,673,14,687
2205,0,0,67,453,520
1893,0,0,452,19,471
170,0,0,42,1,43
0,0,0,0,0,0
289,0,0,193,2,195
205,0,0,95,0,95
329,0,0,69,1,70
124,0,0,28,0,28
188,0,0,90,1,91
284,0,0,0,0,0
298,0,0,0,80,80
583,0,0,84,4,88
213,1,0,0,24,24
5493,4,0,0,221,221
190,0,0,1,14,15
184,0,0,56,1,57
618,0,0,159,3,162
746,0,0,465,13,478
14,0,0,0,0,0
329,0,0,37,1,38
263,1,0,81,9,90
504,0,0,167,1,168
322,0,0,113,13,126
57,0,0,0,1,1
170,0,0,0,11,11
489,0,0,75,6,81
1,0,0,0,0,0
429,0,0,73,4,77
10503,12,0,2329,128,2457
551,0,0,191,14,205
80,0,0,42,0,42
3,0,0,0,0,0
144,0,0,0,0,0
40,0,0,6,6,12
119,0,0,38,4,42
133,0,0,0,0,0
1209,0,0,0,41,41
758,0,0,17,30,47
145,0,0,0,9,9
95,0,0,30,6,36
42,0,0,0,0,0
794,1,0,200,39,239
99,0,0,0,33,33
2,0,0,0,0,0
101,0,0,0,1,1
179,0,0,0,3,3
513,0,0,133,18,151
121,0,0,28,4,32
143,0,0,42,2,44
155,0,0,0,2,2
247,2,0,47,22,69
490,0,0,0,0,0
125,0,0,0,5,5
94,0,0,0,0,0
1685,0,0,0,284,284
1422,0,0,540,14,554
127,0,0,32,1,33
94,0,0,0,4,4
110,0,0,0,2,2
259,0,0,90,9,99
96,0,0,41,0,41
97,0,0,0,3,3
284,0,0,59,6,65
218,1,0,23,48,71
495,0,0,245,3,248
189,0,0,0,1,1
5272,3,0,1764,205,1969
175,0,0,89,23,112
127,0,0,82,5,87
456,0,0,83,6,89
268,0,0,0,16,16
291,0,0,73,0,73
173,0,0,44,6,50
336,0,0,145,0,145
196,0,0,27,7,34
56,0,0,0,5,5
159,0,0,0,22,22
408,1,0,246,15,261
352,0,0,121,0,121
8046,5,0,1121,131,1252
346,0,0,144,14,158
38,0,0,12,0,12
3,0,0,0,1,1
144,0,0,84,0,84
28,0,0,11,5,16
77,0,0,35,3,38
133,0,0,27,3,30
1168,1,0,0,50,50
711,1,0,86,29,115
136,0,0,26,5,31
59,0,0,29,0,29
42,0,0,6,2,8
555,1,0,0,27,27
66,0,0,0,24,24
2,0,0,0,0,0
100,0,0,0,1,1
176,0,0,43,2,45
362,0,0,22,14,36
89,0,0,13,3,16
99,1,0,0,0,0
153,0,0,32,3,35
178,0,0,72,33,105
490,0,0,260,15,275
120,0,0,0,9,9
94,0,0,0,0,0
1401,0,0,72,251,323
868,0,0,306,7,313
94,0,0,19,2,21
90,0,0,43,2,45
108,0,0,48,4,52
160,0,0,51,8,59
55,0,0,15,0,15
94,0,0,0,1,1
219,0,0,118,1,119
147,0,0,0,0,0
247,0,0,47,0,47
188,0,0,0,9,9
3303,0,0,0,103,103
63,0,0,0,0,0
40,0,0,0,1,1
367,0,0,0,0,0
252,0,0,65,6,71
218,0,0,56,6,62
123,0,0,35,1,36
191,0,0,109,0,109
162,0,0,14,6,20
51,0,0,0,12,12
137,0,0,0,0,0
147,0,0,0,0,0
231,0,0,85,2,87
6794,4,0,1651,100,1751
188,0,0,0,0,0
26,0,0,9,0,9
2,0,0,0,1,1
60,0,0,13,1,14
12,0,0,1,1,2
39,0,0,6,3,9
103,0,0,12,0,12
1118,0,0,0,0,0
596,0,0,226,27,253
105,0,0,10,0,10
30,0,0,0,0,0
34,0,0,7,0,7
528,0,0,177,18,195
42,1,0,0,11,11
2,0,0,0,0,0
99,0,0,16,2,18
131,0,0,38,0,38
326,0,0,28,7,35
73,0,0,9,0,9
99,0,0,52,2,54
118,0,0,51,3,54
73,0,0,0,22,22
215,0,0,92,28,120
111,0,0,0,5,5
94,0,0,26,2,28
1078,0,0,42,243,285
555,0,0,234,5,239
73,0,0,7,1,8
45,0,0,0,3,3
56,0,0,21,0,21
101,0,0,26,3,29
40,0,0,27,0,27
93,0,0,0,3,3
100,0,0,0,0,0
147,0,0,23,20,43
200,0,0,35,5,40
179,0,0,0,4,4
3200,0,0,2687,205,2892
63,0,0,20,8,28
39,0,0,0,0,0
367,0,0,51,11,62
181,0,0,24,19,43
156,0,0,48,9,57
87,0,0,27,2,29
82,0,0,46,1,47
142,0,0,37,8,45
39,0,0,0,16,16
137,0,0,0,2,2
147,0,0,0,13,13
144,0,0,45,0,45
5043,3,0,1313,150,1463
188,0,0,85,11,96
17,0,0,10,0,10
1,0,0,0,0,0
46,0,0,0,0,0
10,0,0,0,0,0
30,0,0,12,6,18
91,0,0,23,0,23
1118,4,0,0,45,45
343,0,0,47,17,64
95,0,0,18,3,21
30,0,0,0,5,5
27,0,0,6,3,9
333,0,0,0,4,4
31,0,0,0,9,9
2,0,0,0,0,0
81,0,0,21,1,22
93,0,0,26,0,26
291,0,0,22,6,28
64,0,0,19,2,21
45,0,0,0,3,3
64,0,0,10,0,10
51,0,0,0,8,8
95,0,0,0,3,3
106,0,0,0,3,3
66,0,0,23,1,24
793,0,0,34,205,239
316,0,0,90,4,94
65,0,0,64,0,64
42,0,0,21,1,22
35,0,0,13,1,14
72,0,0,60,5,65
13,0,0,5,1,6
90,0,0,33,5,38
100,0,0,56,2,58
104,0,0,17,6,23
160,0,0,68,2,70
175,0,0,0,2,2
308,0,0,0,0,0
35,0,0,9,1,10
39,0,0,21,1,22
305,0,0,0,0,0
138,0,0,28,6,34
99,0,0,0,0,0
58,0,0,16,1,17
35,0,0,14,3,17
97,0,0,29,11,40
23,0,0,0,2,2
135,0,0,131,2,133
134,0,0,57,8,65
99,0,0,35,1,36
3580,4,0,862,69,931
92,0,0,41,5,46
7,0,0,4,0,4
1,0,0,0,1,1
46,0,0,23,0,23
10,0,0,10,0,10
12,0,0,0,0,0
68,0,0,8,3,11
1073,0,0,226,24,250
279,0,0,109,16,125
74,0,0,17,1,18
25,0,0,3,0,3
18,0,0,0,1,1
329,2,0,79,9,88
22,0,0,0,5,5
2,0,0,0,0,0
59,0,0,14,5,19
67,0,0,26,0,26
263,0,0,0,0,0
43,0,0,3,4,7
42,0,0,24,0,24
54,0,0,18,2,20
43,0,0,26,5,31
92,0,0,0,0,0
103,0,0,5,3,8
42,0,0,22,0,22
554,0,0,18,139,157
222,0,0,85,2,87
1,0,0,0,0,0
20,0,0,20,0,20
21,0,0,6,0,6
7,0,0,0,0,0
7,0,0,1,0,1
52,0,0,0,2,2
42,0,0,0,0,0
81,1,0,13,9,22
90,0,0,18,3,21
173,0,0,154,4,158
308,0,0,0,43,43
25,0,0,7,1,8
17,0,0,0,0,0
305,0,0,73,4,77
104,0,0,88,4,92
99,0,0,36,2,38
41,0,0,8,2,10
18,0,0,2,5,7
57,0,0,50,0,50
21,0,0,0,8,8
2,0,0,0,0,0
69,0,0,7,1,8
63,0,0,22,0,22
2649,3,0,1065,84,1149
46,0,0,7,1,8
3,0,0,1,0,1
0,0,0,0,0,0
23,0,0,0,0,0
0,0,0,0,0,0
12,0,0,0,0,0
57,0,0,7,1,8
823,0,0,0,19,19
154,0,0,9,3,12
56,0,0,8,1,9
22,0,0,3,4,7
17,0,0,2,0,2
241,0,0,82,1,83
17,0,0,0,5,5
2,0,0,0,0,0
40,0,0,6,5,11
41,0,0,0,0,0
263,0,0,53,12,65
36,0,0,30,4,34
18,0,0,6,0,6
34,0,0,11,2,13
12,0,0,6,0,6
92,0,0,0,51,51
95,0,0,16,1,17
20,0,0,19,0,19
397,0,0,3,104,107
135,0,0,52,1,53
1,0,0,0,0,0
0,0,0,0,0,0
15,0,0,4,0,4
7,0,0,0,5,5
6,0,0,6,0,6
50,0,0,11,0,11
42,0,0,0,0,0
59,0,0,9,4,13
69,0,0,12,0,12
15,0,0,0,0,0
265,0,0,0,31,31
17,0,0,3,0,3
17,0,0,7,1,8
228,0,0,48,1,49
12,0,0,0,2,2
61,0,0,28,0,28
31,0,0,0,0,0
11,0,0,6,0,6
7,0,0,0,4,4
13,0,0,0,1,1
2,0,0,0,1,1
61,0,0,15,5,20
41,0,0,6,0,6
1500,2,0,0,47,47
38,0,0,0,1,1
2,0,0,0,0,0
0,0,0,0,0,0
23,0,0,9,0,9
0,0,0,0,0,0
12,0,0,6,0,6
49,0,0,0,0,0
804,0,0,228,26,254
142,0,0,29,1,30
47,0,0,17,0,17
15,0,0,4,0,4
15,0,0,5,0,5
158,0,0,22,1,23
12,0,0,0,5,5
2,0,0,0,1,1
29,0,0,11,3,14
41,0,0,14,0,14
198,0,0,0,1,1
2,0,0,0,0,0
12,0,0,0,0,0
21,0,0,4,3,7
6,0,0,0,1,1
41,0,0,0,28,28
78,0,0,21,2,23
1,0,0,0,0,0
290,0,0,10,86,96
82,0,0,32,1,33
1,0,0,0,0,0
0,0,0,0,0,0
11,0,0,0,0,0
2,0,0,0,0,0
0,0,0,0,0,0
39,0,0,19,2,21
42,0,0,0,0,0
46,0,0,4,5,9
57,0,0,9,0,9
15,0,0,0,0,0
234,0,0,0,37,37
14,0,0,1,3,4
9,0,0,0,0,0
179,0,0,65,0,65
10,0,0,0,4,4
33,0,0,0,0,0
31,0,0,16,5,21
5,0,0,0,0,0
3,0,0,0,0,0
12,0,0,0,4,4
1,0,0,0,0,0
41,0,0,2,1,3
35,0,0,6,0,6
1453,4,0,470,97,567
37,0,0,5,0,5
2,0,0,0,0,0
0,0,0,0,0,0
14,0,0,2,0,2
0,0,0,0,0,0
6,0,0,0,0,0
49,0,0,0,0,0
550,0,0,0,19,19
112,0,0,49,0,49
30,0,0,29,1,30
11,0,0,2,1,3
10,0,0,0,0,0
135,0,0,18,3,21
7,0,0,0,1,1
1,0,0,0,0,0
15,0,0,0,0,0
27,0,0,0,0,0
197,0,0,0,0,0
2,0,0,0,1,1
12,0,0,0,1,1
14,0,0,4,0,4
5,0,0,5,0,5
13,0,0,0,0,0
55,0,0,11,0,11
1,0,0,0,0,0
194,0,0,8,40,48
49,0,0,0,0,0
1,0,0,0,1,1
0,0,0,0,0,0
11,0,0,0,0,0
2,0,0,0,0,0
0,0,0,0,0,0
18,0,0,0,0,0
42,0,0,18,2,20
37,0,0,31,2,33
48,0,0,0,0,0
15,0,0,0,0,0
197,0,0,0,29,29
10,0,0,1,0,1
9,0,0,8,0,8
114,0,0,23,7,30
6,0,0,0,2,2
33,0,0,0,1,1
10,0,0,0,0,0
5,0,0,0,0,0
3,0,0,0,2,2
8,0,0,0,0,0
1,0,0,0,0,0
38,0,0,5,2,7
29,0,0,12,1,13
886,4,0,270,65,335
32,0,0,0,0,0
2,0,0,0,0,0
0,0,0,0,0,0
12,0,0,4,0,4
0,0,0,0,0,0
6,0,0,0,0,0
49,0,0,11,2,13
531,0,0,0,9,9
63,0,0,9,6,15
0,0,0,0,0,0
8,0,0,0,0,0
10,0,0,0,0,0
114,0,0,45,5,50
6,0,0,0,4,4
1,0,0,0,0,0
15,0,0,0,0,0
27,0,0,0,0,0
197,0,0,11,1,12
1,0,0,0,0,0
11,0,0,7,0,7
10,0,0,2,1,3
0,0,0,0,0,0
13,0,0,0,5,5
44,0,0,15,0,15
1,0,0,0,0,0
146,0,0,10,30,40
49,0,0,12,1,13
0,0,0,0,0,0
0,0,0,0,0,0
11,0,0,0,0,0
2,0,0,0,0,0
0,0,0,0,0,0
18,0,0,0,1,1
22,0,0,0,0,0
4,0,0,0,3,3
48,0,0,32,0,32
15,0,0,0,0,0
168,0,0,0,43,43
9,0,0,1,0,1
1,0,0,0,0,0
84,0,0,13,4,17
4,0,0,0,2,2
32,0,0,13,-1,12
10,0,0,3,2,5
5,0,0,0,0,0
1,0,0,0,0,0
8,0,0,0,3,3
1,0,0,0,0,0
31,0,0,10,0,10
16,0,0,8,0,8
551,1,0,0,32,32
32,0,0,0,0,0
2,0,0,1,0,1
0,0,0,0,0,0
8,0,0,0,0,0
6,0,0,0,0,0
36,0,0,5,1,6
522,0,0,0,7,7
48,0,0,27,2,29
8,0,0,2,0,2
10,0,0,0,0,0
64,0,0,24,0,24
2,0,0,0,0,0
15,0,0,0,0,0
185,0,0,15,0,15
1,0,0,0,0,0
4,0,0,0,0,0
7,0,0,0,0,0
8,0,0,0,6,6
29,0,0,9,3,12
106,0,0,0,26,26
36,0,0,0,0,0
2,0,0,0,1,1
17,0,0,0,0,0
22,0,0,4,0,4
1,0,0,0,0,0
16,0,0,0,0,0
15,0,0,0,0,0
125,0,0,16,11,27
8,0,0,1,0,1
67,0,0,19,0,19
2,0,0,0,0,0
20,0,0,0,1,1
5,0,0,0,0,0
1,0,0,0,0,0
5,0,0,0,4,4
21,0,0,3,0,3
8,0,0,0,0,0
519,6,0,370,53,423
32,0,0,12,0,12
1,0,0,0,0,0
30,0,0,1,0,1
515,0,0,0,0,0
19,0,0,0,0,0
6,0,0,0,0,0
40,0,0,7,7,14
2,0,0,0,0,0
170,0,0,41,1,42
2,0,0,0,0,0
17,0,0,0,0,0
80,0,0,8,20,28
1,0,0,0,0,0
17,0,0,0,0,0
18,0,0,6,0,6
1,0,0,0,0,0
15,0,0,0,0,0
98,0,0,28,16,44
7,0,0,0,0,0
48,0,0,16,0,16
19,0,0,6,0,6
5,0,0,0,0,0
1,0,0,0,0,0
1,0,0,0,0,0
18,0,0,0,0,0
96,4,0,0,20,20
20,0,0,0,0,0
29,0,0,0,0,0
515,0,0,0,0,0
26,0,0,0,0,0
2,0,0,0,0,0
128,0,0,0,0,0
2,0,0,0,0,0
52,0,0,0,18,18
1,0,0,0,0,0
12,0,0,0,0,0
54,0,0,0,0,0
32,0,0,0,0,0
13,0,0,5,0,5
5,0,0,0,0,0
1,0,0,0,0,0
76,2,0,0,18,18
20,0,0,0,0,0
34,0,0,0,16,16
8,0,0,6,1,7
58,3,0,0,24,24
18,0,0,0,9,9
1,0,0,0,0,0
34,3,0,0,4,4
9,0,0,0,0,0
1,0,0,0,0,0
30,3,0,0,12,12
18,1,0,0,9,9
9,0,0,0,0,0
